{
    "size": {
        "width": 25,
        "height": 15
    },

    "file": "Wooden_tileset",

    "listSquare": [
        [32, 6, 6, 6, 6, 6, 6, 6, 6, 6, 6, 6, 29, 6, 6, 6, 6, 6, 6, 6, 6, 6, 6, 6, 35],
        [7, 2, 2, 2, 2, 2, 2, 2, 2, 2, 2, 2, 14, 2, 2, 2, 2, 2, 2, 2, 2, 2, 2, 2, 9],
        [7, 2, 2, 2, 2, 2, 2, 2, 2, 2, 2, 2, 14, 2, 2, 2, 2, 2, 2, 2, 2, 2, 2, 2, 9],
        [7, 0, 0, 0, 0, 0, 0, 0, 0, 0, 0, 0, 14, 0, 0, 0, 0, 0, 0, 0, 0, 0, 0, 0, 9],
        [7, 0, 0, 0, 0, 0, 18, 0, 0, 0, 0, 0, 14, 0, 0, 0, 0, 0, 0, 0, 0, 0, 0, 0, 9],
        [7, 0, 0, 0, 0, 19, 21, 17, 0, 0, 0, 0, 14, 0, 0, 0, 0, 0, 0, 0, 0, 0, 0, 4, 9],
        [7, 0, 0, 0, 0, 2, 16, 2, 0, 0, 0, 0, 14, 3, 3, 3, 3, 3, 3, 3, 3, 3, 3, 5, 9],
        [7, 0, 0, 0, 0, 2, 2, 2, 0, 0, 0, 0, 16, 3, 3, 3, 3, 3, 3, 3, 3, 3, 3, 4, 9],
        [7, 0, 0, 0, 0, 0, 2, 0, 0, 0, 0, 0, 2, 1, 1, 1, 1, 1, 1, 1, 1, 1, 1, 1, 9],
        [7, 0, 0, 0, 0, 0, 0, 0, 0, 0, 0, 0, 2, 0, 0, 0, 0, 0, 0, 0, 0, 0, 0, 0, 9],
        [7, 0, 0, 0, 0, 0, 20, 0, 0, 0, 0, 0, 0, 0, 0, 0, 0, 0, 0, 0, 0, 0, 0, 0, 9],
        [7, 0, 0, 0, 0, 0, 2, 0, 0, 0, 0, 0, 0, 0, 0, 0, 0, 0, 0, 0, 0, 0, 0, 0, 9],
        [7, 0, 0, 0, 0, 0, 2, 0, 0, 0, 0, 0, 0, 0, 0, 0, 0, 0, 0, 0, 0, 0, 0, 0, 9],
        [7, 0, 0, 0, 0, 0, 0, 0, 0, 0, 0, 0, 0, 0, 0, 0, 0, 0, 0, 0, 0, 0, 0, 0, 9],
        [33, 8, 8, 8, 8, 8, 8, 8, 8, 8, 8, 8, 8, 8, 8, 8, 8, 8, 8, 8, 8, 8, 8, 8, 34]
    ]
}