{
    "size": {
        "width": 25,
        "height": 15
    },

    "file": "Wooden_tileset",

    "obstacles": [
        2, 3, 6, 7, 8, 9, 10, 11, 12, 13, 14, 15, 16, 17, 18, 19, 20, 21, 22, 23, 24, 25, 26, 27, 28, 29, 30, 31, 32, 33, 34, 35
    ],

    "weights": {
        "0": 0.6,
        "1": 0.6,
        "4": 0.9,
        "5": 0.9
    },

    "listSquare": [
        [32, 6 , 6 , 6 , 6 , 6 , 6 , 6 , 6 , 6 , 6 , 6 , 29, 6 , 6 , 6 , 6 , 6 , 6 , 6 , 6 , 6 , 6 , 6 , 35],
        [7 , 2 , 2 , 2 , 2 , 2 , 2 , 2 , 2 , 2 , 2 , 2 , 14, 2 , 2 , 2 , 2 , 2 , 2 , 2 , 2 , 2 , 2 , 2 , 9 ],
        [7 , 2 , 2 , 2 , 2 , 2 , 2 , 2 , 2 , 2 , 2 , 2 , 14, 2 , 2 , 2 , 2 , 2 , 2 , 2 , 2 , 2 , 2 , 2 , 9 ],
        [7 , 0 , 0 , 0 , 0 , 0 , 0 , 0 , 0 , 0 , 0 , 0 , 14, 4 , 0 , 0 , 0 , 0 , 0 , 0 , 0 , 0 , 0 , 0 , 9 ],
        [7 , 0 , 0 , 0 , 0 , 0 , 0 , 0 , 0 , 0 , 0 , 0 , 14, 5 , 3 , 3 , 3 , 3 , 3 , 3 , 3 , 3 , 3 , 3 , 9 ],
        [7 , 4 , 0 , 0 , 0 , 0 , 0 , 0 , 0 , 0 , 0 , 0 , 14, 1 , 1 , 1 , 1 , 1 , 1 , 1 , 1 , 1 , 1 , 5 , 9 ],
        [7 , 5 , 3 , 3 , 0 , 0 , 0 , 0 , 0 , 0 , 0 , 0 , 14, 3 , 3 , 3 , 3 , 3 , 3 , 3 , 3 , 3 , 3 , 5 , 9 ],
        [7 , 1 , 1 , 1 , 3 , 3 , 3 , 0 , 0 , 0 , 0 , 0 , 14, 1 , 1 , 1 , 1 , 1 , 1 , 1 , 1 , 1 , 1 , 1 , 9 ],
        [7 , 0 , 0 , 0 , 1 , 1 , 1 , 3 , 3 , 3 , 3 , 3 , 16, 0 , 0 , 0 , 0 , 0 , 0 , 0 , 0 , 0 , 0 , 0 , 9 ],
        [7 , 0 , 0 , 20, 0 , 0 , 0 , 1 , 1 , 1 , 1 , 1 , 2 , 0 , 0 , 0 , 0 , 0 , 0 , 0 , 0 , 20, 0 , 0 , 9 ],
        [7 , 0 , 0 , 2 , 0 , 0 , 0 , 0 , 0 , 0 , 0 , 0 , 2 , 0 , 0 , 0 , 0 , 0 , 0 , 0 , 0 , 2 , 0 , 0 , 9 ],
        [7 , 0 , 0 , 2 , 0 , 0 , 0 , 0 , 0 , 0 , 0 , 0 , 0 , 0 , 0 , 0 , 0 , 0 , 0 , 0 , 0 , 2 , 0 , 0 , 9 ],
        [7 , 0 , 0 , 0 , 0 , 0 , 0 , 0 , 0 , 0 , 0 , 0 , 0 , 0 , 0 , 0 , 0 , 0 , 0 , 0 , 0 , 0 , 0 , 0 , 9 ],
        [7 , 0 , 0 , 0 , 0 , 0 , 0 , 0 , 0 , 0 , 0 , 0 , 0 , 0 , 0 , 0 , 0 , 0 , 0 , 0 , 0 , 0 , 0 , 0 , 9 ],
        [33, 8 , 8 , 8 , 8 , 8 , 8 , 8 , 8 , 8 , 8 , 8 , 8 , 8 , 8 , 8 , 8 , 8 , 8 , 8 , 8 , 8 , 8 , 8 , 34]
    ]
}