{
    "size": {
        "width": 25,
        "height": 15
    },

    "file": "Simple_tileset",

    "listTile": {
        "0": {"namespace": "MAP","key": "RANDOM"},
        "1": {"namespace": "MAP","key": "GRASS", "weight": 0.7},
        "2": {"namespace": "MAP","key": "GROUND", "weight": 0.6},
        "3": {"namespace": "MAP","key": "TREE", "weight": 1, "isBlocked": true},
        "4": {"namespace": "MAP","key": "BUISSON", "weight": 1.5, "isBlocked": false}
    },

    "listSquare": [
        [3, 3, 3, 3, 3, 3, 3, 3, 3, 3, 3, 3, 3, 3, 3, 3, 3, 3, 3, 3, 3, 3, 3, 3, 3],
        [3, 2, 2, 2, 2, 2, 2, 2, 2, 2, 2, 2, 2, 2, 2, 2, 2, 2, 2, 2, 2, 2, 2, 2, 3],
        [3, 2, 1, 1, 1, 1, 1, 1, 1, 1, 1, 1, 1, 1, 1, 1, 1, 1, 1, 1, 1, 1, 1, 2, 3],
        [3, 2, 1, 1, 4, 4, 4, 4, 4, 1, 4, 1, 1, 1, 4, 1, 4, 4, 4, 4, 4, 1, 1, 2, 3],
        [3, 2, 1, 1, 1, 1, 1, 1, 4, 1, 4, 1, 1, 1, 4, 1, 1, 1, 4, 1, 1, 1, 1, 2, 3],
        [3, 2, 1, 1, 1, 1, 1, 4, 1, 1, 4, 1, 1, 1, 4, 1, 1, 1, 4, 1, 1, 1, 1, 2, 3],
        [3, 2, 1, 1, 1, 1, 1, 4, 1, 1, 4, 1, 1, 1, 4, 1, 1, 1, 4, 1, 1, 1, 1, 2, 3],
        [3, 2, 1, 1, 1, 1, 4, 1, 1, 1, 4, 1, 1, 1, 4, 1, 1, 1, 4, 1, 1, 1, 1, 2, 3],
        [3, 2, 1, 1, 1, 4, 1, 1, 1, 1, 4, 1, 1, 1, 4, 1, 1, 1, 4, 1, 1, 1, 1, 2, 3],
        [3, 2, 1, 1, 1, 4, 1, 1, 1, 1, 4, 1, 1, 1, 4, 1, 1, 1, 4, 1, 1, 1, 1, 2, 3],
        [3, 2, 1, 1, 4, 1, 1, 1, 1, 1, 4, 1, 1, 1, 4, 1, 1, 1, 4, 1, 1, 1, 1, 2, 3],
        [3, 2, 1, 1, 4, 4, 4, 4, 4, 1, 4, 4, 4, 4, 4, 1, 1, 1, 4, 1, 1, 1, 1, 2, 3],
        [3, 2, 1, 1, 1, 1, 1, 1, 1, 1, 1, 1, 1, 1, 1, 1, 1, 1, 1, 1, 1, 1, 1, 2, 3],
        [3, 2, 2, 2, 2, 2, 2, 2, 2, 2, 2, 2, 2, 2, 2, 2, 2, 2, 2, 2, 2, 2, 2, 2, 3],
        [3, 3, 3, 3, 3, 3, 3, 3, 3, 3, 3, 3, 3, 3, 3, 3, 3, 3, 3, 3, 3, 3, 3, 3, 3]
    ]
}